Alanine_aminotransferase	/oak/stanford/groups/mrivas/projects/biomarkers/sumstats_diverse/white_british/plink_imputed/filtered/INT_Alanine_aminotransferase_all.glm.linear.filtered.maf001.info03.tsv.gz
Albumin	/oak/stanford/groups/mrivas/projects/biomarkers/sumstats_diverse/white_british/plink_imputed/filtered/INT_Albumin_all.glm.linear.filtered.maf001.info03.tsv
Alkaline_phosphatase	/oak/stanford/groups/mrivas/projects/biomarkers/sumstats_diverse/white_british/plink_imputed/filtered/INT_Alkaline_phosphatase_all.glm.linear.filtered.maf001.info03.tsv
Apolipoprotein_A	/oak/stanford/groups/mrivas/projects/biomarkers/sumstats_diverse/white_british/plink_imputed/filtered/INT_Apolipoprotein_A_all.glm.linear.filtered.maf001.info03.tsv
Apolipoprotein_B_adjstatins	/oak/stanford/groups/mrivas/projects/biomarkers/sumstats_diverse/white_british/plink_imputed/filtered/INT_Apolipoprotein_B_adjstatins_all.glm.linear.filtered.maf001.info03.tsv
Apolipoprotein_B	/oak/stanford/groups/mrivas/projects/biomarkers/sumstats_diverse/white_british/plink_imputed/filtered/INT_Apolipoprotein_B_all.glm.linear.filtered.maf001.info03.tsv
Aspartate_aminotransferase	/oak/stanford/groups/mrivas/projects/biomarkers/sumstats_diverse/white_british/plink_imputed/filtered/INT_Aspartate_aminotransferase_all.glm.linear.filtered.maf001.info03.tsv
Calcium	/oak/stanford/groups/mrivas/projects/biomarkers/sumstats_diverse/white_british/plink_imputed/filtered/INT_Calcium_all.glm.linear.filtered.maf001.info03.tsv
Cholesterol_adjstatins	/oak/stanford/groups/mrivas/projects/biomarkers/sumstats_diverse/white_british/plink_imputed/filtered/INT_Cholesterol_adjstatins_all.glm.linear.filtered.maf001.info03.tsv
Cholesterol	/oak/stanford/groups/mrivas/projects/biomarkers/sumstats_diverse/white_british/plink_imputed/filtered/INT_Cholesterol_all.glm.linear.filtered.maf001.info03.tsv
C_reactive_protein	/oak/stanford/groups/mrivas/projects/biomarkers/sumstats_diverse/white_british/plink_imputed/filtered/INT_C_reactive_protein_all.glm.linear.filtered.maf001.info03.tsv
Creatinine_in_urine	/oak/stanford/groups/mrivas/projects/biomarkers/sumstats_diverse/white_british/plink_imputed/filtered/INT_Creatinine_in_urine_all.glm.linear.filtered.maf001.info03.tsv
Creatinine	/oak/stanford/groups/mrivas/projects/biomarkers/sumstats_diverse/white_british/plink_imputed/filtered/INT_Creatinine_all.glm.linear.filtered.maf001.info03.tsv
Cystatin_C	/oak/stanford/groups/mrivas/projects/biomarkers/sumstats_diverse/white_british/plink_imputed/filtered/INT_Cystatin_C_all.glm.linear.filtered.maf001.info03.tsv
Direct_bilirubin	/oak/stanford/groups/mrivas/projects/biomarkers/sumstats_diverse/white_british/plink_imputed/filtered/INT_Direct_bilirubin_all.glm.linear.filtered.maf001.info03.tsv
eGFR	/oak/stanford/groups/mrivas/projects/biomarkers/sumstats_diverse/white_british/plink_imputed/filtered/INT_eGFR_all.glm.linear.filtered.maf001.info03.tsv
Fasting_glucose	/oak/stanford/groups/mrivas/projects/biomarkers/sumstats_diverse/white_british/plink_imputed/filtered/INT_Fasting_glucose_all.glm.linear.filtered.maf001.info03.tsv
Gamma_glutamyltransferase	/oak/stanford/groups/mrivas/projects/biomarkers/sumstats_diverse/white_british/plink_imputed/filtered/INT_Gamma_glutamyltransferase_all.glm.linear.filtered.maf001.info03.tsv
Glucose	/oak/stanford/groups/mrivas/projects/biomarkers/sumstats_diverse/white_british/plink_imputed/filtered/INT_Glucose_all.glm.linear.filtered.maf001.info03.tsv
Glycated_haemoglobin_HbA1c	/oak/stanford/groups/mrivas/projects/biomarkers/sumstats_diverse/white_british/plink_imputed/filtered/INT_Glycated_haemoglobin_HbA1c_all.glm.linear.filtered.maf001.info03.tsv
HDL_cholesterol	/oak/stanford/groups/mrivas/projects/biomarkers/sumstats_diverse/white_british/plink_imputed/filtered/INT_HDL_cholesterol_all.glm.linear.filtered.maf001.info03.tsv
IGF_1	/oak/stanford/groups/mrivas/projects/biomarkers/sumstats_diverse/white_british/plink_imputed/filtered/INT_IGF_1_all.glm.linear.filtered.maf001.info03.tsv
LDL_direct_adjstatins	/oak/stanford/groups/mrivas/projects/biomarkers/sumstats_diverse/white_british/plink_imputed/filtered/INT_LDL_direct_adjstatins_all.glm.linear.filtered.maf001.info03.tsv
LDL_direct	/oak/stanford/groups/mrivas/projects/biomarkers/sumstats_diverse/white_british/plink_imputed/filtered/INT_LDL_direct_all.glm.linear.filtered.maf001.info03.tsv
Lipoprotein_A	/oak/stanford/groups/mrivas/projects/biomarkers/sumstats_diverse/white_british/plink_imputed/filtered/INT_Lipoprotein_A_all.glm.linear.filtered.maf001.info03.tsv
Microalbumin_in_urine	/oak/stanford/groups/mrivas/projects/biomarkers/sumstats_diverse/white_british/plink_imputed/filtered/INT_Microalbumin_in_urine_all.glm.linear.filtered.maf001.info03.tsv
Non_albumin_protein	/oak/stanford/groups/mrivas/projects/biomarkers/sumstats_diverse/white_british/plink_imputed/filtered/INT_Non_albumin_protein_all.glm.linear.filtered.maf001.info03.tsv
Oestradiol	/oak/stanford/groups/mrivas/projects/biomarkers/sumstats_diverse/white_british/plink_imputed/filtered/INT_Oestradiol_all.glm.linear.filtered.maf001.info03.tsv
Phosphate	/oak/stanford/groups/mrivas/projects/biomarkers/sumstats_diverse/white_british/plink_imputed/filtered/INT_Phosphate_all.glm.linear.filtered.maf001.info03.tsv
Potassium_in_urine	/oak/stanford/groups/mrivas/projects/biomarkers/sumstats_diverse/white_british/plink_imputed/filtered/INT_Potassium_in_urine_all.glm.linear.filtered.maf001.info03.tsv
Rheumatoid_factor	/oak/stanford/groups/mrivas/projects/biomarkers/sumstats_diverse/white_british/plink_imputed/filtered/INT_Rheumatoid_factor_all.glm.linear.filtered.maf001.info03.tsv
SHBG	/oak/stanford/groups/mrivas/projects/biomarkers/sumstats_diverse/white_british/plink_imputed/filtered/INT_SHBG_all.glm.linear.filtered.maf001.info03.tsv
Sodium_in_urine	/oak/stanford/groups/mrivas/projects/biomarkers/sumstats_diverse/white_british/plink_imputed/filtered/INT_Sodium_in_urine_all.glm.linear.filtered.maf001.info03.tsv
Testosterone	/oak/stanford/groups/mrivas/projects/biomarkers/sumstats_diverse/white_british/plink_imputed/filtered/INT_Testosterone_all.glm.linear.filtered.maf001.info03.tsv
Total_bilirubin	/oak/stanford/groups/mrivas/projects/biomarkers/sumstats_diverse/white_british/plink_imputed/filtered/INT_Total_bilirubin_all.glm.linear.filtered.maf001.info03.tsv
Total_protein	/oak/stanford/groups/mrivas/projects/biomarkers/sumstats_diverse/white_british/plink_imputed/filtered/INT_Total_protein_all.glm.linear.filtered.maf001.info03.tsv
Triglycerides	/oak/stanford/groups/mrivas/projects/biomarkers/sumstats_diverse/white_british/plink_imputed/filtered/INT_Triglycerides_all.glm.linear.filtered.maf001.info03.tsv
Urate	/oak/stanford/groups/mrivas/projects/biomarkers/sumstats_diverse/white_british/plink_imputed/filtered/INT_Urate_all.glm.linear.filtered.maf001.info03.tsv
Urea	/oak/stanford/groups/mrivas/projects/biomarkers/sumstats_diverse/white_british/plink_imputed/filtered/INT_Urea_all.glm.linear.filtered.maf001.info03.tsv
Vitamin_D	/oak/stanford/groups/mrivas/projects/biomarkers/sumstats_diverse/white_british/plink_imputed/filtered/INT_Vitamin_D_all.glm.linear.filtered.maf001.info03.tsv.gz
